################################
#..............................#
#..............................#
#........##########............#
#........#........#............#
#........#........#............#
#........##########............#
#..............................#
################################
