################################
#.............#................#
#.####.#####..#..#######.######.
#.#  #.#   #..#..#     #.#    #.
#.#  #.#   ####..# ### #.# ## #.
#.#..#.#........... ### #.# ## #.
#.#..#.#############     #.#    #
#......#..................#.....#
################################
