################################
#.............#................#
#.####.#####..#..#######.######.
#.#..#.#...#..#..#.....#.#....#.
#.#..#.#...####..#.###.#.#.##.#.
#.#..#.#............###.#.#.##.#
#.#..#.#############.....#.#....
#......#..................#.....
################################
